############
#          O
#          #
    @ *    %
#          #  
#          O
############