####################
##########        %#
      #####*      ##
##### ####### ######
## @    ##### ######
##    *   ### ######
####          ######
####       #########
####################