########%#########
######*   *#######
###O    @    #####
####         #####
##### ############
##### ############
##### ###### * ###
      ######   ###
#####         ####
###########O######