#############
#         #%#
      #   # #
#    *#     #
######## #######
      #       *#
      #    @   #
      ###O######