###################
#*               *#
#  ## @ ##    @   #
   ##   ##     ####
#        %        #
##    @    ## ##  #
#   #    ####O##  #
#*  #      @  #  *#
###################