########%#########
######*   *#######
###O    @    #####
####  @   @  #####
##### ############
##### ############
##### ###### * ###
      ######@ @###
#####         ####
###########O######