############
#     @    O
#          #
    @ * @  %
#          #  
#     @    O
############