#############
#  @      #%#
      # @ # #
#    *#     #
######## #######
      #       *#
      #    @   #
      ###O######