####################
##########O  @    %#
      #####*    @ ##
##### ####### ######
## @    ##### ######
##    *   ### ######
####          ######
####   @  O#########
####################