###############
#	 	      #
#*#######   # #
##        # #*#
    #  ########
# * #   @ # % # 
#####  # ##   #
##     #     *#
###############