###################
#*               *#
#  ## @ ##        #
   ##   ##     ####
#        %        #
##         ## ##  #
#   #    #######  #
#*  #         #  *#
###################