###############
#	@	   @  #
#*#######   # #
##        # #*#
    #  ########
# * #   @ # % # 
#####  # ##@  #
#O @   #     *#
###############